tropical = {

}

arid = {
	463 1765 3268 3265 3329 461 1363 889 1617 1440 1780 873 1364 1384 3333 1441 1361 483 1348 1349 491
	478 3271 1377 444 456 1383 3272 3266 1182 1189 3267 476 1185 865 1183 1186 1190 488 3104 430 521 507 522 3100 494 1188 497 3122 495 1615 3125 508 524 632 634 811 842 798 3117 772 1326 801 3111 3121 1329 635 1184 3350 888 1071 499 501 502 504 503 2954 2955 754 1579 1299 1317 1611  
	465 481 1353 1355 485 1380 1276 268 1378 1345 1354 1283 2183 636 1282 440 1281 1284 1293 1279 1280 1101 794 758 788 2756 441 881 1784  1695 1402 1614 1616 1335 1613 1320 1350 1351 1352 1612 887 1330 3012 1118 1109 1110 890 3351 
	3352 1119 1307 1224 1113 906 3331 1120 3106 3108 1121 1223 1295 1362 891 1401 1371 795 1399 1334
}

arctic = {
    1618 1556 1225 1152 1557 1155 1226 892 896 894 897 1154 893 2007 1153 1156 1619 1151 1166 1157 879 1167 1965 1964 845 848 1229 877 1143 862 859 846 704 847 1991 850 903 1558 860 861 829 878 782 780 1209 786 823 825 820 828 599 781 601 902 835 783 777 824 840 598 785 1487 1602 1508 1603 #1523 #1481 #1569
	3309 3310 3311 3338 2760 3312 2759 2761 2762 2763 2766 2765 3014
	3349 2780 2770 2769 2773 2776 2772 2774 2782 2778 2775 2768 2784 2777 2771 2783
	2795 2796 2800 2797 2812 2818 2798 2803 2805 2804 2806 2794 2819 #1523 #1481 #1569 
	2813 2815 2814
	2785 3337 602 776 1208 836 3313
}

mild_winter = {
	1344 1387 1356 1398 679 1343 1395 666 350 1065 351 1059 1066 349 348 1063 347 355 345 1093 1070 645 1092 1085 346 1094 344 853 1068 343 852 342 1069 1400 1404 1096 341 1089 1090 1083 1088 357 642 1082 356 1091 372 1850 241 243 1847 239 252 240 1844 671 340 855
	856 328 857 329 330 1067 1058 858 331 1062 332 1061 333 646 1095 1060 1087 1405 336 334 416 669 656 338 337 851 414 1814 1813 79 78 82 80 81 648 649 87 86 94 92 93 670 643 85 83 84 74 1804 73 72 75 76 77 88 90 91 89 379 1838 381 1837 104 299 96 259 103 1580 1835 263 261 1836 260 173 1834 1831 1817 264 1832 265 1581 1592 1594 1595
	300 1833 105 1497 172 1816 174 1493 171 1499 170 284 162 169 168 415 335 167 107 262 165 166 1812 164 1810 99 1505 1507 1811 1802 1809 101 1791 98 1805 854 97 1789 339 1788 1790 100 1806 1807 152 1792 1407 1793 1794 1424 153 1857 155 157 1795 154 156 1796 159 1800 1799 161 1801 1803 1503 163 1501 1815 1498 1496 298 106 1442 1818 362 291 1819 301 227 383 371 364 226 386
	1588 1872 1370 1367 1365 1369 1368 1866 160 1808 1798 1797 1867 1294 1873 283 285 282 1870 1871 676 1467 1477 1469 1868 1855 288 1468 1476 1862 1474 1462 1434 1357 1472 1431 1457 1473 377 1453 378 1437 1458 1433 1435 1417 1864 1470 1460 380 224 119 223 744 120 2168 228 980 225 1313 1314 1315 1316 229 1421 370 1418 981 184 230 1308 1310 1311 1443 1312 1490 1510 382 1448 
	1492 1449 388 1506 1452 366 1491 1500 1494 1450 1444 1859 1865 158 1856 1495 1966 1502 1359 1514 677 369 1640 286 1459 1358 376 1446 1471 1436 1447 1861 1451 1512 1641 1454 1455 1475 1598 1584 1860 1464 1025 190 118 121 117 115 114 111 113 110 112 109 1044 2 68 3 655 2164 413 10 13 18 19 2169 29 30 222 219 220 218 1302 993 213 209 197 1305 210 205 1306 203 202 1032 200 201 185 982 
	733  361 42 43 3070 3069 3221 3081 3051 3143 116 3330 3135 3136 3137 3138 3073 3316 3317 3131 3191 3190 3318 3320 3319 3128 3129 3149 3132 3224 3130 3223 3133 3134 3193 3192 3321 3322 3323 3325 3324 3326 1415 3327 3194 3195 3205 3207 3203 3208 3204 3206 3209 3202 3210 3200
	3457 3458 3433 3434 3431 3432 3430 3429 3444 3445 3446 3435 3442 3441 3439 3436 3440 3437 3438 3443
}

normal_winter = {
	353 352 354 1852 1851 374 373 245 1849 250 251 1853 1848 1845 244 1846 1841 644 253 1839 95 248 249 1854 1840 1843 255 247 1597 266 1578 1596 1576 1961 1389 1842 175 297 254 295 257 1391 1445 293 384 292 232 1416 412 367 385 2157 1360 1423 1824 375 359 1892 1858 1381 1382 1593 1828 1388 1830 1822 365 674 294 302 1826 1821 1823 368 256 387 1422 1419 363 1394 1589 1590 1583 1587 1679
	390 742 1883 391 267 1882 1884 393 684 685 407 686 1886 394 1887 683 672 673 408 1898 314 315 526 321 1900 712 317 1937 1918 1680 1899 1895 1897 411 316 402 1904 530 532 533 1950 1954 695 1624 702 1623 703 833 564 1949 693 1948 553 1582 1681 1591 64 192 1049 278 269 270 1642 275 70 1042 188 279 1878 277 392 280 289 745 233 1877 389 1001 271 661 1045 1043 322 323 276 1939 306 404 397 574 312 1880 1905 313 1879 318 1911 1881 1140 405 406 1913 1912 309 308 310 552 1914 324 311 303 304 305 1908 1907 307 1909 1910
	1906 1936 1938 403 1935 554 1934 400 581 576 1932 1944 583 1933 579 568 1011 1013 1010 585 586 1693 588 1008 594 589 590 582 1009 1012 1100 567 557 1930 1014 570 1931 1929 1947 1967 398 551 556 555 1927 566 1928 565 1926 1925 1924 399 1917 563 578 550 1920 1921 1916 1915 1023 821 699 690 701 1672 571 1627 596 819 569 818 841 1919 698 1626 1015 1922 1923 834 1081 1629 595 1080 700 1628 962 1250 1670 1675 1430 1645 1650 1251 778 779 1432 898 1643 969 968 895 1708 1707 1703 1653 970 984 972 1635 1572 1674 2327 
	830 832 831 775 1659 1665 1662 1677 1666 1655 1649 1644 1717 1664 1658 1694 1676 1646 1661 1720 1632 1709 1571 1719 1726 1721 1715 2323 1716 1705 1630 1688 1479 1555 1516 1546 1480 2137 2138 2142 2141 717 290 1678 722 721 1026 654 3198 3197 3199 3201
	3139 3141 3142  3156 3157 3158 3155 3159 3168 3186 3188 3187 3172 3162 3154 3163 3169 3167 3173 3165 3359 3360 3152 3151 3150 3153 3334 3290 2832 2833 2828 2834 2827 2894 2895 2896 2897 2903 2898 2899 2901 2900 2002 2139 2140 2890 2889 2892 2891 2893 2836 2830 2831 2826 2824 2846 2847 2850 2860 2884 2861 2888 2887 2886 2902 2885 2823 2845 3017 2849 2851 2855 2858 2854 2853 2852 2848 2856
	3425 3424 3426 3422 3427 3428 3447 3449 3452 3448 3451 3455 3454 3453 3450 3412 3413 3395 3396 3394 3388 3390 3399 3389 3401 3403 3402 3391 3393 3392 3404 3407 3406 3410 3409 3411 3408 3405 2829
}

severe_winter = {
	893 1153 1151 1156 1166 1157 879 1229 877 862 1143 1031 2018 859 903 1991 1558 850 861 878 783 782 829 780 1209 847 704 846 845 848  892 894 896 897 1152 1154 1155 1619 1167 1965 1964 1570 651 1963 1577 652 1575 296 1827 1960 681 682 620 1439 1889 628 1894 1130 640 680 409 410 752 1139 1896 849 663 549 1825 662 1145 1158 1150 1149 1148 882 619 886 664 665 883 872 866 1160 707 1159 678 614 1990 706 667 708 817 826 860 786 823 602 820 825 598 828 835 777 902 599 781 776 1208 836 601 824 816 840 785 844 822 839 600 2324 784 1638 1599 1601 1639 1573 1574 1487 1602 1508 1603 1029 1682 964 1660 973 971 1648 1647 1654 1636 974 976 975 1225 1226 1556 730 731 1557 1618 1386 1959 689 612 1820 1485 1427 1829 1489 1488 1486 1956 607 605 606 687 1957 1958 615 1438 609 610 1962 611 1482 608 613 401 258 242 246 102 1863 1142 1047 358 1888 688 746 1876 396 1890 618 1885 1893 395 705 787 1891 617 319 320 1133 616 885 1134 668 1951 1903 287 531 1953 538 561 1022 537 718 562 560 535 716 711 1901 1902 528 527 529 534 1952 536 1955 694 696 710 692 697 961 1625 709 1622 1651 234 714 235 1050 1144 1064 1054 1057 1056 1053 1086 237 650 236 1084 729
	715 1017 1018 572 1016 1019 1420 791 1393 1396 1874 1397 1392 1126 558 1127 1128 1875 1129 741 1390 660 1146 1869 559 1385 1946 738 1585 713 743 657 653 658 1052 1051 1055 3309 3310 3311 3338 2760 3312 2759 2761 2762 2763 2766 2765 3014
	3349 2780 2770 2769 2773 2776 2772 2774 2782 2778 2775 2768 2784 2777 2771 2783 
	2785 3337 3313 2758 2757 3347 3170 3185 3171 3160 3314 3161 3166 3180 3182 3183 3184 3179 3178 3216 3175 3289 3174 3341 2764 2767 2786 2787 2779 1600
	2825 2810 2820 2842 2821 2822 2838 2837 2841 2840 2839 2816 2817 2808 2809 2811 3016 2792 2790 2788 2789 2791 3015 3164
	2793 2799 2801 2795 2796 2800 2797 2812 2818 2798 2803 2805 2804 2806 2794 2819 #1523 #1481 #1569 
	2813 2815 2814 2802
	3423 3420 3456 3419 3418 3348 3227 739 740 281 3417 3416 3415 3414 3176 3177
}
#691 726 2337 238 768 716 729 727
impassable = { 
	711 712 713 714 715  717 718 
	719 720 721 722 723 724 725   728 
	730 731 732 733 734 735 736 737  
	845 846 848 1168 1366 1968
	2325 2326 2328 2329 2330 
	2331 2332 2333 2335 2336  2338
	691 726 2337 238 768 716 729 727
	3011 3014 3522 3573 3601 2334
}

mild_monsoon = {

}

normal_monsoon = {

}

severe_monsoon = {

}

equator_y_on_province_image = 656