tropical = {

}

arid = {
	463 1765 3268 3329 461 1363 889 1617 1440 1780 873 1364 1384 3333 1441 1361 483 1348 1349 491
	478 3271 1377 444 456 1383 3272 3266 1182 1189 3267 476 1185 865 1183 1186 1190 488 3104 430 521 507 522 3100 494 1188 497 3122 495 1615 3125 508 524 632 634 811 842 798 3117 772 1326 801 3111 3121 1329 635 1184 3350 888 1071 499 501 502 504 503 2954 2955 754 1579 1299 1317 1611  
	465 481 1353 1355 485 1380 1276 268 1378 1345 1354 1283 2183 636 1282 440 1281 1284 1293 1279 1280 1101 794 758 788 2756 441 881 1784  1695 1402 1614 1616 1335 1613 1320 1350 1351 1352 1612 887 1330 3012 1118 1109 1110 890 3351 
	3352 1119 1307 1224 1113 906 3331 1120 3106 3108 1121 1223 1295 1362 891 1401 1371 795 1399 1334 4033 792 1403 4024 1479 4029 2172 2173
}

arctic = {
    1618 1556 1225 1152 1557 1155 1226 892 896 894 897 1154 893 2007 1153 1156 1619 1151 1166 1157 879 1167 1965 1964 845 848 1229 877 1143 862 859 846 704 847 1991 850 903 1558 860 861 829 878 782 780 1209 823 825 828 599 781 601 902 835 783 777 824 840 598 785 1487 1602 1603 #1523 #1481 #1569
	3309 3310 3311 2760 3312 2759 2761 2762 2763 2766 2765 3014
	3349 2780 2770 2769 2773 2776 2772 2774 2782 2778 2775 2768 2784 2777 2771 2781 2783 3556 3541 3564 3532 3537 3557 3564
	2795 2796 2800 2797 2812 2818 2798 2803 2805 2804 2806 2794 #1523 #1481 #1569 
	2785 3313 3337 3966 2789 1682 2788 1029 3965
}

mild_winter = {
	1344 1387 1356 1398 679 1343 1395 666 350 1065 351 1059 1066 349 348 1063 347 355 345 1093 1070 645 1092 1085 346 1094 344 853 1068 343 852 342 1069 1400 1404 1096 341 1089 1090 1083 1088 357 642 1082 356 1091 372 1850 241 243 1847 239 252 240 1844 671 340 855
	856 328 857 329 330 1067 1058 858 331 1062 332 1061 333 646 1095 1060 1087 1405 336 334 416 669 656 338 337 851 414 1814 1813 79 78 82 80 81 648 649 87 86 94 92 93 670 643 85 83 84 74 1804 73 72 75 76 77 88 90 91 89 379 1838 381 1837 104 299 96 259 103 1580 1835 263 261 1836 260 173 1834 1831 1817 264 1832 265 1581 1592 1594 1595
	300 1833 105 1497 172 1816 174 1493 171 1499 170 284 162 169 168 415 335 167 107 262 165 166 1812 164 1810 99 1505 1507 1811 1802 1809 101 1791 98 1805 854 97 1789 339 1788 1790 100 1806 1807 152 1792 1407 1793 1794 1424 153 1857 155 157 1795 154 156 1796 159 1800 1799 161 1801 1803 1503 163 1501 1815 1498 1496 298 106 1442 1818 362 291 1819 301 227 383 371 364 226 386
	1588 1872 1370 1367 1365 1369 1368 1866 160 1808 1798 1797 1867 1294 1873 283 285 282 1870 1871 676 1467 1477 1469 1868 1855 288 1468 1476 1862 1474 1462 1434 1357 1472 1431 1457 1473 377 1453 378 1437 1458 1433 1435 1417 1864 1470 1460 380 224 119 223 744 120 2168 228 980 225 1313 1314 1315 1316 229 1421 370 1418 981 184 230 1308 1310 1311 1443 1312 1490 1510 382 1448 
	1492 1449 388 1506 1452 366 1491 1500 1494 1450 1444 1859 1865 158 1856 1495 1966 1502 1359 1514 677 369 1640 286 1459 1358 376 1446 1471 1436 1447 1861 1451 1512 1641 1454 1455 1475 1598 1584 1860 1464 1025 190 118 121 117 115 114 111 113 110 112 109 1044 2 68 3 655 2164 413 10 13 18 19 2169 29 30 222 219 220 218 1302 993 213 209 197 1305 210 205 1306 203 202 1032 200 201 185 982 
	733  361 42 43 3070 3069 3221 3081 3051 3143 116 3330 3135 3136 3137 3138 3073 3316 3317 3131 3191 3190 3318 3320 3319 3128 3129 3149 3132 3224 3130 3223 3133 3134 3193 3192 3321 3322 3323 3325 3324 1415 3327 3194 3195 3205 3207 3203 3208 3204 3206 3209 3202 3210 3200
	3457 3458 3433 3434 3431 3432 3430 3429 3444 3445 3446 3435 3442 3441 3439 3436 3440 3437 3438 3443 595 700 1080 3521
	3217 189 3219 1046 3147 3315 3144 274 191 1024 192 3139 64 188 1042 70 279 1048 3140 3146 272 661 271 1045 3148 1001 278 1049 270 3142 1642 3141 275 277 1878 392 280 289 389 1877 233 3156 745 312 3157 3158 303 304 3155 305 1907 3599 1910 307
	397 404 269 306 1939 276 323 322 1938 1936 400 576 3387 3385 3386 1932 403 1935 554 1922 1967 1947 1929 1934 581 1933 3145 3218 1043 583 579 1931 570 1014 3395 3153 3396 1011 568 1013 1010 1941 1944 3361 1942 587 1745 585 1747 1943 593 3397 1945 591 592 586 577 3400 575 582 3389 590 3290 1012 1009 3401 3399 589 594 3390 1008 3388 1693 588 1100 567 557 1930 3150
	1694 1658 1662 775 830 3405 2327 3536 2834 1719 962 1675 1628 3402 1670 3404 1664 1717 1644 1649 3410 1666 1677 3409 3570 3569 2836 2893 2885 2886 2891 1726 3487 3488 3489 3495 3490 3491 3493 3486 3492 3485 3494 3500 3499 
	1741 1702 3601 1517 2103 2011 2014 2020 1274 2977 4057
	2981 806 802 465 1615 3125 508 3403 1529 1239 1528 1519 3498 3906 3921 3905 3912 3919 3922 3936 3916 3918 3920 3923 3924 3946 3968 3973 3971 3972 3975 3980 4037 3986 3981 3989 3990 3987 3985 3994 3993 3992 3991 4059 4060
}

normal_winter = {
	353 352 354 1852 1851 374 373 245 1849 250 251 1853 1848 1845 244 1846 1841 644 253 1839 95 248 249 1854 1840 1843 255 247 1597 266 1578 1596 1576 1961 1389 1842 175 297 254 295 257 1391 1445 293 384 292 232 1416 412 367 385 2157 1360 1423 1824 375 359 1892 1858 1381 1382 1593 1828 1388 1830 1822 365 674 294 302 1826 1821 1823 368 256 387 1422 1419 363 1394 1589 1590 1583 1587 1679
	390 742 1883 391 267 1882 1884 393 684 685 407 686 1886 394 1887 683 672 673 408 1898 314 315 526 321 1900 712 317 1937 1918 1680 1899 1895 1897 411 316 402 1904 530 532 533 1950 1954 695 1624 702 1623 703 833 564 1949 693 1948 553 1582 1681 1591 1909 1880 1905 313 1879 318 1911 1881 1140 405 406 1913 1912 309 308 310 552 1914 324 311 1908    
	1906 398 551 556 555 1927 566 1928 565 1926 1925 1924 399 1917 563 578 550 1920 1921 1916 1915 1023 821 699 690 701 1672 571 1627 596 819 569 818 841 1919 698 1626 1015 1923 834 1081 1629 1250 1430 1645 1650 1251 778 779 1432 898 1643 969 968 895 1708 1707 1703 1653 970 984 972 1635 1572 1674  
	1655 1709 717 290 1678 722 721 1026 654 3198 3197 3199 3201 2880 725 724
	3159 3168 3186 3188 3187 3172 3162 3154 3163 3169 3167 3173 3165 3359 3360 3152 3151 3334 2832 2833     2830 2831 2826 2824 2846 2847 2850 2860 2884 2861 2888 2887   2823 2845 3017 2849 2851 2855 2858 2854 2853 2852 2848 2856 4058
	3425 3424 3426 3422 3427 3428 3447 3449 3452 3448 3451 3455 3454 3453 3450 3412 3413 3394 3391 3393 3392 3407 3406 2829
	1040 1027 1038 1039 1041 1035 1033 1037 1034 3509 3507 1030 3505 3508 3506
	2333 2873 2871 2872 2870 2877 2875 2883 2876 3546  2882 2881 2878 2879 2868 2867 2865 2864 2863 2857 2869 2862 3595 3550 3560 3561 3548 3549 3597 3562 3398 3600 3551 
	3518 3516 3523 3524 3566 2016 3520 3519 3522 728 3542 2007 3529 2004 3543 2012 2013 3554 3342 3539 3356 1714 2048 1998 2024 3575 3586
	768 757 2980 932 2978 505 3336 2964 2963 2911 2962 2944 492 959 629 630 3346 3013 3345 3339
	3344 3340 837 3530 843 3114 1206 737 1205 1207 1203 1230 1525 1234 1238 3326 1237 1204 3226 3951 3902 3907 3903 3904 3901 3935 3934 3927 3926 3931 3929 3933 3930 3928 3915 3900 3914 3937 3932 3938 3939 3925 3911 3908 3949 3955 3957 3954 3958 3960 3959 3963 3961 3953 3962 3956 3947 3944 3983 3988 3977 3976 3978 4035 3982 3979 3970 3974 3984 4036 4051 4050
}

severe_winter = {
	893 1153 1151 1156 1166 1157 879 1229 877 862 1143 1031 2018 859 903 1991 1558 850 861 878 783 782 829 780 1209 847 704 846 845 848  892 894 896 897 1152 1154 1155 1619 1167 1965 1964 1570 651 1963 1577 652 1575 296 1827 1960 681 682 620 1439 1889 628 1894 1130 640 680 409 410 752 1139 1896 849 663 549 1825 662 1145 1158 1150 1149 1148 882 619 886 664 665 883 872 866 1160 707 1159 678 614 1990 706 667 708 817 826 860 786 823 602 820 825 598 828 835 777 902 599 781 776 1208 836 601 824 816 840 785 844 822 839 600 2324 784 1638 1599 1601 1639 1573 1574 1487 1602 1508 1603 1029 1682 964 1660 973 971 1648 1647 1654 1636 974 976 975 1225 1226 1556 730 731 1557 1618 1386 1959 689 612 1820 1485 1427 1829 1489 1488 1486 1956 607 605 606 687 1957 1958 615 1438 609 610 1962 611 1482 608 613 401 258 242 246 102 1863 1142 1047 358 1888 688 746 1876 396 1890 618 1885 1893 395 705 787 1891 617 319 320 1133 616 885 1134 668 1951 1903 287 531 1953 538 561 1022 537 718 562 560 535 716 711 1901 1902 528 527 529 534 1952 536 1955 694 696 710 692 697 961 1625 709 1622 1651 234 714 235 1050 1144 1064 1054 1057 1056 1053 1086 237 650 236 1084 729
	715 1017 1018 572 1016 1019 1420 791 1393 1396 1874 1397 1392 1126 558 1127 1128 1875 1129 741 1390 660 1146 1869 559 1385 1946 738 1585 713 743 657 653 658 1052 1051 1055 3309 3310 3311 3338 2760 3312 2759 2761 2762 2763 2766 2765 3014
	3349 2780 2770 2769 2773 2776 2772 2774 2782 2778 2775 2768 2784 2777 2771 2783 
	2785 3337 3313 2758 2757 3347 3170 3185 3171 3160 3314 3161 3166 3180 3182 3183 3184 3179 3178 3216 3175 3289 3174 3341 2764 2767 2786 2787 2779 1600
	2825 2810 2820 2842 2821 2822 2838 2837 2841 2840 2839 2816 2817 2808 2809 2811 3016 2792 2790 2788 2789 2791 3015 3164
	2793 2799 2801 2795 2796 2800 2797 2812 2818 2798 2803 2805 2804 2806 2794 2819 #1523 #1481 #1569 
	2813 2815 2814 2802
	3423 3420 3456 3419 3418 3348 3227 739 740 281 3417 3416 3415 3414 3176 3177
	3501 3503 3553 2781 3556 3541 3564 3557 3558 3565 3537 3532 3533 3573 3598 3596 1523 1481 1569 1028 1036 727 1147 3534 3531 3535 3544 3567 3497 3572 3496
	3552 3011 3547 2866 2859 3525 3555 3527 3512 3511 3513 3510 3514 
	3355 3358 3357 2019 3526 3899 3941 3940 3563 3913 3910 3909 3967 3965 3966 3964 4049 4013 3515 4047 4048 4039 4040 4038 3517 3995 2874
}
#691 726 2337 238 768 716 729 727
impassable = { 
	711 712 713 714 715  717 718 
	719 720 721 722 723 724 725   728 
	730 731 732 733 734 735 736 737  
	845 846 848 1168 1968
	2325 2326 2328 2329 2330 
	2331 2332 2333 2335 2336  2338
	691 726 2337 238 768 716 729 727
	3011 3014 3522 3573 3601 2334 3899
	4052 4054 4055 4058
}

mild_monsoon = {

}

normal_monsoon = {

}

severe_monsoon = {

}

equator_y_on_province_image = 656