width = 5632
height = 2048

max_provinces = 4056
sea_starts = {
	2184 2185 2186 2187 2188 2189 2190 2191 2192 
	2193 2194 2195 2196 2197 2198 2199 2200 2201 2202 
	2203 2204 2205 2206 2207 2208 2209 2210 2211 2212 
	2213 2214 2215 2216 2217 2218 2219 2220 2221 2222 
	2223 2224 2225 2226 2227 2228 2229 2230 2231 2232 
	2233 2234 2235 2236 2237 2238 2239 2240 2241 2242 
	2243 2244 2245 2246 2247 2248 2249 2250 2251 2252 
	2253 2254 2255 2256 2257 2258 2259 2260 2261 2262 
	2263 2264 2265 2266 2267 2268 2269 2270 2271 2272 
	2273 2274 2275 2276 2277 2278 2279 2280 2281 2282 
	2283 2284 2285 2286 2287 2288 2289 2290 2291 2292 
	2293 2294 2295 2296 2297 2298 2299 2300 2301 2302 
	2303 2304 2305 2306 2307 2308 2309 2310 2311 2312 
	2313 2315 2316 2317 2318 2319 2320 2321 
	2339 2340 2341 2342 
	2343 2344 2345 2346 2347 2348 2349 2350 2351 2352 
	2353 2354 2355 2356 2357 2358 2359 2360 2361 2362
	2363 2364 2365 2366 2367 2368 2369 2370 2371 2372
	2373 2374 2375 2376 2377 2378 2379 2380 2381 2382
	2383 2384 2385 2386 2387 2388 2389 2390 2391 2392
	2393 2394 2395 2396 2397 2398 2399 2400 2401 2402
	2403 2404 2405 2406 2407 2408 2409 2410 2411 2412
	2413 2414 2415 2416 2417 2418 2419 2420 2421 2422
	2423 2424 2425 2426 2427 2428 2429 2430 2431 2432
	2433 2434 2435 2436 2437 2438 2439 2440 2441 2442
	2443 2444 2445 2446 2447 2448 2449 2450 2451 2452
	2453 2454 2455 2456 2457 2458 2459 2460 2461 2462
	2463 2464 2465 2466 2467 2468 2469 2470 2471 2472
	2473 2474 2475 2476 2477 2478 2479 2480 2481 2482
	2483 2484 2485 2486 2487 2488 2489 2490 2491
	2493 2494 2495 2496 2497 2498 2499 2500 2501 2502
	2503 2504 2505 2506 2507 2508 2509 2510 2511 2512
	2513 2514 2515 2516 2517 2518 2519 2520 2521 2522
	2523 2524 2525 2526 2527 2528 2529 2530 2531 2532
	2533 2534 2535 2536 2537 2538 2539 2540 2541 2542
	2543 2544 2545 2546 2547 2548 2549 2550 2551 2552
	2553 2554 2555 2556 2557 2558 2559 2560 2561 2562
	2563 2564 2565 2566 2567 2568 2569 2570 2571 2572
	2573 2574 2575 2576 2577 2578 2579 2580 2581 2582
	2583 2584 2585 2586 2587 2588 2589 2590 2591 2592
	2593 2594 2595 2596 2597 2598 2599 2600 2601 2602
	2603 2604 2605 2606 2607 2608 2610 2611 2612
	2613 2614 2615 2616 2617 2618 2619 2620 2621 2622
	2623 2624 2625 2626 2627 2628 2629 2630 2631 2632
	2633 2634 2635 2636 2637 2638 2639 2640 2641 2642
	2643 2644 2645 2646 2647 2648 2649 2650 2651 2652
	2653 2654 2655 2656 2657 2658 2659 2660 2661 2662
	2663 2664 2665 2666 2667 2668 2669 2670 2671 2672
	2673 2674 2675 2676 2677 2678 2679 2680 2681 2682
	2683 2684 2685 2686 2687 2688 2689 2690 2691 2692
	2693 2694 2695 2696 2697 2698 2699 2700 2701 2702
	2703 2704 2705 2706 2707 2708 2709 2710 2711 2712
	2713 2714 2715 2716 2717 2718 2719 2720 2721 2722
	2723 2724 2725 2754 2755 2170 3614 3615 3616
	3617 3618 3619 3620 3621 3622 3623 3624 3625 3626
	3627 3628 3629 3630 3631 3632 3633 3634 3635 3636
	3637 3638 3639 3640 3641 3642 3643 3644 3645 3646
	3647 3648 3649 3650 3651 3652 3653 3654 3655 3656
	3657 3658 3659 3660 3661 3662 3663 3664 3665 3666
	3667 3668 3669 3670 3671 3672 3673 3674 3675 3676
	3677 3678 3679 3680 3681 3682 3683 3684 3685 3686
	3687 3688 3689 3690 3691 3692 3693 3694 3695 3696 
	3697 3698 3699 3700 3701 3702 3703 3704 3705 3706 
	3707 3708 3709 3710 3711 3712 3713 3714 3715 3716 
	3717 3718 3719 3720 3721 3722 3723 3724 3725 3726 
	3727 3728 3729 3731 3732 3733 3734 3735 3736 
	3737 3738 3739 3740 3741 3742 3743 3744 3745 3746 
	3747 3748 3749 3750 3751 3752 3753 3754 3755 3756 
	3757 3758 3759 3760 3761 3762 3763 3764 3765 3766 
	3767 3768 3769 3770 3771 3772 3773 3774 3775 3776 
	3777 3778 3779 3780 3781 3782 3783 3784 3785 3786 
	3787 3788 3789 3790 3791 3792 3793 3794 3795 3796 
	3797 3798 3799 3800 3801 3802 3803 3804 3805 3806 
	3807 3808 3809 3810 3811 3812 3813 3814 3815 3816 
	3817 3818 3819 3820 3821 3822 3823 3824 3825 3826 
	3827 3828 3829 3830 3831 3832 3833 3834 3835 3836 
	3837 3838 3839 3840 3841 3842 3843 3844 3845 3846 
	3847 3848 3849 3850 3851 3852 3853 3854 3855 3856 
	3857 3858 3859 3860 3861 3862 3863 3864 3865 3866 
	3867 3868 3869 3870 3871 3872 3873 3874 3875 3876 
	3877 3878 3879 3880 3881 3882 3883 3884 3885 3886 
	3887 3888 3889 3890 3891 3892 3893 3894 3895 3896 
	3897 3898
}

only_used_for_random = {
    # Disable unused IDs
    1366 2257 2258 2259 2260 2261 2262 2263 2264 2265 2266 2267 2268 2269 2270 2271 2273 2274 2275 2276 2277 2278 2279 2280 2281 2282 2283 2284 2285 2286 2287 2290 2291 2293 2294 2295 2296 2297 2298 2299 2300 2301 2302 2303 2304 2305 2306 2307 2308 2309 2310 2311 2312 2313 2315 2316 2317 2318 2319 2320 2321 2325 2326 2328 2329 2330 2331 2332 2338 2349 2357 2652 3677 3894
    2333 2334 2335 2336 2314 2609 2492
}

lakes = {
	2171 2172 2173 2174 2175 2176 2177 2178 2179 
	2180 2181 2182 2681 2682 2683 2726 2727 2728 2729
	2730 2731 2732 2733 2734 2735 2736 2737 2738 2739
	2740 2741 2742 2743 2744 2745 2746 2747 2748 2749
	2750 2751 2752 2753 2807 3612 3613 3730 4053
}

force_coastal = {

}

definitions = "definition.csv"
provinces = "provinces.bmp"
positions = "positions.txt"
terrain = "terrain.bmp"
rivers = "rivers.bmp"
terrain_definition = "terrain.txt"
heightmap = "heightmap.bmp"
tree_definition = "trees.bmp"
continent = "continent.txt"
adjacencies = "adjacencies.csv"
climate = "climate.txt"
region = "region.txt"
superregion = "superregion.txt"
area = "area.txt"
provincegroup = "provincegroup.txt"
ambient_object = "ambient_object.txt"
seasons = "seasons.txt"
trade_winds = "trade_winds.txt"

# Define which indices in trees.bmp palette which should count as trees for automatic terrain assignment
tree = { 3 4 7 10 }

